1111111111111111111111111111111111
1E1000100000000C00000C000000000001
1010101100100000101001000000010101
1010101001101010001001000000010101
1P0010E00C00C0000000000000000000C1
1111111111111111111111111111111111