1111111111111
10C10000000C1
101001C111001
1P0011E000001
1111111111111