111111111111111111111111111111111
1E0000000000000C0000C000000000001
101001010010000001001000000010101
101001001010101001001000000010101
1P0000000C00C000000000000000000C1
111111111111111111111111111111111